observation 1,observation 2,observation 3,observation 4,observation 5,total
11,2,8,2,4,27
1,1,11,2,1,16
1,7,1,1,9,19
5,1,3,6,5,20
13,2,3,3,4,25
3,2,6,1,5,17
2,2,8,3,1,16
1,3,4,6,5,19
2,8,1,1,4,16
13,10,15,5,2,45
3,6,1,5,8,23
9,1,18,3,1,32
3,7,14,3,1,28
7,7,1,8,1,24
4,1,6,1,1,13
1,14,2,3,7,27
19,9,7,1,8,44
5,1,1,6,1,14
9,5,6,2,2,24
8,15,2,3,3,31
4,7,11,4,6,32
7,5,1,14,8,35
3,3,5,21,10,42
11,1,6,1,2,21
4,1,2,11,5,23
3,5,4,10,3,25
1,4,7,3,2,17
3,5,4,2,3,17
5,1,4,11,17,38
1,13,13,2,1,30
